4,4,4,4,4,4,4,4,4,4,4,4
4,4,4,4,4,4,4,4,4,4,4,4
4,4,4,4,4,4,4,4,4,4,4,4
4,4,4,0,2,0,0,0,0,4,4,4
4,4,4,1,4,4,0,0,0,4,4,4
4,4,4,0,0,0,0,0,0,4,4,4
4,4,4,0,0,0,2,0,0,4,4,4
4,4,4,0,0,0,0,0,0,4,4,4
4,4,4,0,0,0,0,0,3,4,4,4
4,4,4,4,4,4,4,4,4,4,4,4
4,4,4,4,4,4,4,4,4,4,4,4
4,4,4,4,4,4,4,4,4,4,4,4