4,4,4,4,4,4,4,4,4,4,4,4
4,4,4,4,1,0,0,0,2,4,4,4
4,4,4,4,0,0,5,0,0,4,4,4
4,4,4,4,0,0,0,0,0,4,4,4
4,4,4,4,4,4,0,4,4,4,4,4
4,0,0,0,0,0,0,0,0,0,0,4
4,0,1,0,0,0,0,0,0,0,2,4
4,0,0,0,0,0,0,4,4,0,0,4
4,0,0,0,0,0,0,4,4,0,2,4
4,0,1,0,0,0,0,0,0,0,0,4
4,0,0,0,0,3,0,0,0,0,0,4
4,4,4,4,4,4,4,4,4,4,4,4